   WE                            textures/wolfenstein/grey_stone.png
NO      textures/wolfenstein/purple_stone.png



SO textures/wolfenstein/red_brick.png

F 17,38,64

EA textures/wolfenstein/wood.png



C 218,234,235

1111111111111111111111111
100110000100000000000001111
1000110000000000111W11111
100011000000000011000101111
1000000000100000000001001
1111111111111111111111111
