				C 153,204,255
NO textures/simonkraft/wet_sponge.xpm
WE textures/simonkraft/wet_sponge.xpm
EA textures/simonkraft/wet_sponge.xpm


F 164,169,025
SO textures/simonkraft/wet_sponge.xpm

111                  1111111111111111111111
11111111111111 11111111111
111111111111111 1111111111
111111111111111 1111111111111111111111111111111111111111111111111
111111111111111 1111111111111111111111111111111111111
111111   1  1  1111111 1111111111111111111
111111111 1111111111111111
100000N000000001
1000000101      1
11111111111111111
