NO textures/theame2/north.xpm
SO textures/theame2/south.xpm
WE textures/theame2/west.xpm
EA textures/theame2/east.xpm
F 220,100,0
C 0,0,0

111111
100001
1000N1
1111110