WE textures/wolfenstein/grey_stone.xpm
NO      textures/wolfenstein/purple_stone.xpm



SO textures/wolfenstein/red_brick.xpm

F 17,38,64

EA textures/wolfenstein/wood.xpm



C 218,234,235

1111111111111111111111111
10011000010000000000000111
100011000000000011     1W11111
100011000000000011000101111
1000000000100000000001001
1111111111111111111111111
